 | From svn.tartarus.org/snowball/trunk/website/algorithms/portuguese/stop.txt
 | This file is distributed under the BSD License.
 | See http://snowball.tartarus.org/license.php
 | Also see http://www.opensource.org/licenses/bsd-license.html
 |  - Encoding was converted to UTF-8.
 |  - This notice was added.

 | A Portuguese stop word list. Comments begin with vertical bar. Each stop
 | word is at the start of a line.


 | The following is a ranked list (commonest to rarest) of stopwords
 | deriving from a large sample of text.

 | Extra words have been added at the end.

de             |  of, from
a              |  the; to, at; her
o              |  the; him
que            |  who, that
e              |  and
do             |  de + o
da             |  de + a
em             |  in
um             |  a
para           |  for
  | é          from SER
com            |  with
não            |  not, no
uma            |  a
os             |  the; them
no             |  em + o
se             |  himself etc
na             |  em + a
por            |  for
mais           |  more
as             |  the; them
dos            |  de + os
como           |  as, like
mas            |  but
  | foi        from SER
ao             |  a + o
ele            |  he
das            |  de + as
  | tem        from TER
à              |  a + a
seu            |  his
sua            |  her
ou             |  or
  | ser        from SER
quando         |  when
muito          |  much
  | há         from HAV
nos            |  em + os; us
já             |  already, now
  | está       from EST
eu             |  I
também         |  also
só             |  only, just
pelo           |  per + o
pela           |  per + a
até            |  up to
isso           |  that
ela            |  he
entre          |  between
  | era        from SER
depois         |  after
sem            |  without
mesmo          |  same
aos            |  a + os
  | ter        from TER
seus           |  his
quem           |  whom
nas            |  em + as
me             |  me
esse           |  that
eles           |  they
  | estão      from EST
você           |  you
  | tinha      from TER
  | foram      from SER
essa           |  that
num            |  em + um
nem            |  nor
suas           |  her
meu            |  my
às             |  a + as
minha          |  my
  | têm        from TER
numa           |  em + uma
pelos          |  per + os
elas           |  they
  | havia      from HAV
  | seja       from SER
qual           |  which
  | será       from SER
nós            |  we
  | tenho      from TER
lhe            |  to him, her
deles          |  of them
essas          |  those
esses          |  those
pelas          |  per + as
este           |  this
  | fosse      from SER
dele           |  of him